111111111111
1P0000100C11
101110110011
1000000E0001
100011111001
100000000001
111111111111
