111111111111111
1P00000000000C1
100011111111101
100000000000001
101111111110101
1000000E0000001
101111101111101
1C0000000000001
111111111111111
