111111111111111111111
1P00000000000000000C1
100111111111111111101
100000000000000000001
111101111111110111101
1C00000E0000000000001
111111101111111111101
100000000000000000001
101111111111111111101
100000000000000000001
111111111111111111111
